wRwwwwwwwwwwwww
w.ww.ww....ww.w
w........w....w
ww.ww..w.w.wwww
ww.ww..w.w.w..G
ww....ww.w.w..w
w..ww..w...w..w
ww.....ww.w..ww
ww.www.w..w.www
w.............w
w.www.wwwwww..w
w.w....ww....ww
w.w.ww..w.w.www
w....w....w...w
wwwwwwwwwwwwwww