wRwwwwwwwwwwwww
w.ww.ww....ww.w
w.....w..w....w
wwwww.ww.w.wwww
wwwww.ww.w.w..G
ww....ww.w.w.ww
w..wwwww.w.w.ww
ww.......w.w.ww
www.wwwwww.w.ww
w..........w.ww
w.wwwwwwwwww.ww
w.w....ww....ww
w.w.ww.ww.w.www
w....w....w...w
wwwwwwwwwwwwwww